11111111111
101100E1C11
10001C1C001
101000100C1
1000P110101
11111111111